  
                                      ##########
                                     #########
   $###         ##    ##   ##       #######
     ####        ##    ##   ##      #######
      #####       #     #    #      #####   ##
        #######################################
        #######################################
        ##################################  ##
      #####       #     #    #      #####
     ####        ##    ##   ##      #######
    ####        ##    ##   ##       #######
                                     ########
                                      #########
